XXXXEXXXXXXXXXXXXXEXXXXXXXXXXXXXXXXXXXXXXXXXXXXXXXXXXXXXXXEXXXXXXXXXXXXXXXX
X    X      X           X                 X                 X   X         X
X XXX X X X X XXXXXXXXX X X XXX X XXXXXXX X XXXXX XXXXXXX X X X X X XXX X X
X X   X  X  X X     X   X  X  X  X        X      X       X    X X  X   X  X
X X X X X X X X X X X XXX X X X X XXX XXXXXXX X X X X XXX XXX X X X X X X X
X   X X   X X X  X  X X   X   X     X X      X    X X        X    X   X   X
X XXX XXX X X X X XXX X XXX XXXXXXX X X X X X XXX X XXXXX XXX XXXXX X X X X
X   X   X X   X     X X   X       X  X   X        X     X           X X  XX
XXX XXX X XXXXXXXXX X XXX XXX X X X X X X XXXXXXXXXXXXX X XXX X XXXXX X X X
X   X   X   X       X   X X    X  X X   X X       X   X  X   X       X    X
X X X X XXX X X XXX XXX X X X X X X X XXX X X XXX X X X X X X XXXXX X XXX X
X  X  X   X    X    X   X    X    X         X X    X  X     X       X     X
XXX X X X XXX X X XXX XXXXXXX X XXX  S  XXXXX X XXX X X XXX X XXXXXXX XXXXX
X      X     X  X   X         X   X     X     X        X    X       X X   X
X XXXXX X X X X XXX X X XXX X XXX X XXX X XXXXX XXX XXX X X XXXXX X X X X X
X   X    X      X    X  X  X    X X   X X      X    X   X  X     X     X  E
X X X XXX X XXXXX X X X X X XXX X X X X XXX X X XXXXX X X X X X X XXXXX X X
X X X       X   X  X    X       X  X    X  X    X     X X    X            X
X X XXXXXXX X X X X X XXXXX X XXX X XXXXX X XXX X XXX X XXX X XXXXXXX XXX X
X X        X  X X   X     X  X    X       X     X    X    X           X   X
X X XXXXX X X X X X XXX X XXX X X X XXX X X X XXXXX X X X XXXXXXXXXXX X XXX
X  X    X     X  X     X  X   X  X     X  X  X      X    X    X      X    X
X X X X XXXXX X X XXX X X X X X X XXXXX X X X X XXX X XXX X X X X X X XXX X
X     X      X          X   X             X        X        X    X        X
XXXXXXXXXXXXXXXXXXXXXXXXXXXXXXXXXXXXXXXXXXXXXXXXXXXXXXXXXEXXXXXXXXXXXXXXXXX
